#########
#       #
#   P   #
#       #
#########