   #########   
  #         #  
 #           # 
#      P      #
 #           # 
  #         #  
   #########   